R 760 480
NO includes/textures/north.xpm
SO includes/textures/south.xpm
WE includes/textures/west.xpm
EA includes/textures/east.xpm
S includes/textures/imposter.xpm
F 184,113,39
C 51,198,227

11111111111111111111111111111
10000000001100000000000000001
10110000001100000200000000S01
10000020000000000020000000001
10000000001100000002000000001
10000000001100000000011110001
11000111001111001100000010001
11000111001111001100110010001
11000000000000001100000010001
10000020000000001100000010001
10000000000000001100010000001
11000000110101000000000000001
11110000110101000000200000001
10000000000000000100000010001
10000000000000000000000001001
10000002000000000000000001001
10000000200000000000000000001
10000000000000000000000000001
11111111111111111111111111111