R 760 480
NO includes/textures/north.xpm
SO includes/textures/south.xpm
WE includes/textures/west.xpm
EA includes/textures/east.xpm
S includes/textures/imposter.xpm
F 184,113,39
C 51,198,227
1111
1021
1S11
1111